on
1-0-1-9-7-u-0-_-a-1-9-7
1-0-3-5-0-u-0-_-a-3-5-0
1-0-2-6-0-u-0-_-a-2-6-0
1-0-2-0-4-u-0-_-a-2-0-4
1-0-4-3-2-u-0-_-a-4-3-2
